...........
.l.......r.
...l...r...
.l.......r.
....sss....
.l.sssss.r.
...sssss...

...........
...........
...........
...........
...........
...........
...........

...........
...........
...........
....xxx....
...........
...........
...........

...........
.xx........
...........
...........
...........
........xx.
...........

...........
........xx.
...........
...........
...........
.xx........
...........

...........
........xx.
...........
....xxx....
...........
.xx........
...........

...........
.xx........
...........
....xxx....
...........
........xx.
...........

...........
.xx.....xx.
...........
...........
...........
.xx.....xx.
...........

...........
.xx.....xx.
...........
....xxx....
...........
.xx.....xx.
...........

...........
.xx.....xx.
...........
.xx.....xx.
...........
.xx.....xx.
...........

...........
...........
..x.....x..
...........
..x.....x..
...........
...........

...........
...........
....xxx....
....xxx....
....xxx....
...........
...........

...........
...........
..xx...xx..
..xx...xx..
..xx...xx..
...........
...........

......xxxxx
........xxx
..........x
...........
..........x
........xxx
......xxxxx

xxxxx......
xxx........
x..........
...........
x..........
xxx........
xxxxx......

...........
.x.......x.
...........
...........
...........
.x.......x.
...........

l.........r
...........
...........
...........
...........
...........
l.........r

...........
...........
..l.....r..
...........
..l.....r..
...........
...........

...........
...........
...........
...l...r...
...........
...........
...........

..x.......x
.x...x...x.
....x...x..
...x...x...
..x...x....
.x...x...x.
x.......x..

...........
.xxxxxxxxx.
...........
...........
...........
.xxxxxxxxx.
...........

...........
.ooo...ooo.
.o.......o.
.o.......o.
.o.......o.
.ooo...ooo.
...........

...........
...........
..x.....x..
.x.......x.
..x.....x..
...........
...........


...........
...........
...........
...x...x...
...........
...........
...........

xxxx...xxxx
xxxx...xxxx
xx.......xx
...........
...........
..x.....x..
...........
